PROMPT_COMMAND='echo -ne "\033]0;${USER}@${HOSTNAME}: ${PWD}\007"'
RCLONE_PASSWORD_COMMAND="/volume1/sec/get_pw.sh"
#Some more alias to avoid making mistakes:
source homebase.sh
alias rm='rm -i'
alias cp='cp -i'
alias mv='mv -i'
alias godo='cd /$homebase/docker_final'
alias rksi='sudo -i'
alias rkma='/$homebase/docker/maker/start.sh'
alias rkba='backup_all.sh'
alias rkst='./start.sh'
alias rkch='sudo chmod +x *.sh; sudo chmod +x yy00; sudo chmod +x ~/bin*'
alias rrkch='sudo chmod +x *; sudo chmod +x ~/bin/*;'
alias rkex='./exe.sh'
alias godop='godocker.sh'
alias rkns='nano start.sh'
alias ss='source setpw.sh; ./start.sh'
alias rknb='nano backup_all.sh'
alias nbash='edit_bash.sh'
alias worker='./worker.sh'
alias start='start_app.sh'
alias starter='start_app.sh'
alias lsa='ls -all -C'
alias lsd='ls -d -all */'
alias semby='cd /$homebase/docker_final/emby | bash start.sh'
alias splex='bash /$homebase/docker_final/plex/start.sh'
alias mypath='ls /usr/path -all'
alias sbash='source ~/.bashrc'
alias gopa='cd /**/docker_final; cd ..; cd docker; cd utils; cd path; lsa'
alias rkpa='godocker.sh /utils/path'
alias rkfi='find.sh'
alias rkre='godocker.sh /restore rkchr.sh'
alias mkcd='mkdir $1 && cd $1'
alias cd..='cd ..'
alias rc='rc.sh'
alias qq='source qq.sh'
alias ee='source ee.sh'
alias ww='source ww.sh'
alias cdu='rclone ncdu . --skip-links'
alias yyps='docker_ps.sh'
alias exe='setpw.sh; exe.sh'
alias yyrr='yyrr.sh'
alias zipme='zipme.sh'
alias log='docker logs -f'

alias yymd='yymd.sh'
alias qq='qq.sh'
alias exe='exe.sh'
alias cdp='cd /$homebase/docker/utils/path'
alias yypa='/$homebase/docker/utils/path'
alias cdd='cd /$homebase/docker'
alias cdf='/$homebase/docker_final'
alias yybean='beanstalkd-cli_linux_amd64 --server 192.168.86.29'
alias yymc='media_center.sh'
alias yymc2='media_center2.sh'
alias yyrc='-P --no-check-certificate --fast-list --skip-links --max-depth 1'
alias cdq='cd /$homebase/cloudhq/q'
alias fido='fido.sh'
alias cdi='cd /$homebase/cloudhq/CENTER/img'
alias pccmc='pcc media_center.sh'
#alias rclone='setpw; rclone --no-check-certificate --fast-list --skip-links'
alias cdcl='source homebase.sh; cd /$homebase/cloudhq'
alias nacr='nano /etc/crontab'
alias rcp='source set-rclone-password'
alias setpw='source setpw.sh'
alias tux='tmuxinator'
alias kodistart='kodi_start.sh'
alias cdw='cd /work'
alias ton='tux start'
alias toff='tux stop'
alias rcc='/root/.config/rclone/rclone.conf'
alias tct='tct.sh'
#alias '+#'='source exit.sh'
alias kk='kk.sh'
#alias fd='fdfind'
alias ttt='tt_starter.sh'
alias tt='tt_enter.sh'
alias wws='wws.sh'
alias ttres='toff tt; sleep 1; ton tt'
alias cd-="cd -"
alias tsend="tsend.sh"
alias sss='ss.sh'
alias gits='gits.sh'
alias aa='clear'
alias aaa='export PS1="|"; clear'
alias aaaa='export $(cat /usr/ps1); clear'
alias yyap='all_panes.sh'
alias cdc='cd ~/.config'
alias yygs='yygs.sh'
#alias rlcone='rclone'
alias yygs='git status'
alias yygc='git commit'
alias cdc='cd ~/.config'
alias yyga='git add .'
alias gup='git push'
alias gdown='git pull'
alias yygc='git_commit.sh'
alias yygg='git_finisher.sh'
alias yyggg='git_finisher.sh 0'
alias yyy='echo; git_finisher.sh 0'
alias cdr='cd /root'
alias cdw='cd /work'
alias zz='zz.sh'

export EDITOR='nano'

function settitle() {
      export PS1="\[\e[32m\]\u@\h \[\e[33m\]\w\[\e[0m\]\n$ "
      echo -ne "\e]0;$1\a"
}
alias yygg='git_finisher.sh'
#alias ls='exa'
#alias ls='better_ls'
alias lls='ls.sh'
alias zas='source /root/.zshrc'
alias pc='pathcopy.sh'
alias nzas='nano /root/.zshrc'
alias waisted='cd /mnt/i/my drive/a_waisted'
alias soo='source'
alias sup='sup.sh'
alias sdo='sdo.sh'
alias cddf='cd /volume2/docker*f*l/'
alias cdd='cd /volume2/docker/'
#alias yy--="~/."
alias psaux='psaux.sh'
alias cclone='rclone --fast-list --skip-links'
alias gg='gg.sh'
alias lss='lss.sh'
alias cdls='cd $1 && ls'
alias sse='sse.sh'
alias cdh='cd ~'
alias ez='exec zsh'
alias grj='source grj.sh'
#alias cdn='cd /volume2/docker_final/setup_new'
alias kdel='kdel.sh'
alias cdb='cd ~/bin'
